....................
....................
............<__>....
....................
~~~~~~~~~~~~~~~~~~~~
####################