..............................................
................................####..........
....<__>...........<_______>..................
<>......<__>..................................
..............................................
~~~~~~~~~~~~~~~~~~~~~~~~~~~~~~~~~~~~~~~~~~~~~~
##############################################
##############################################